###############
#.......#.....#
#.#.###.#.###.#
#.....#.#...#.#
#.###.#####.#.#
#.#.#.......#.#
#.#.#####.###.#
#...........#.#
###.#E#####.#.#
#####.....#.#.#
#.....###.#.#.#
#.....#...#.#.#
#.###.#.#.#.#.#
#S....#...#...#
###############